40 41 41 41 41 40 41 41 40 41 41 41 41 40 41 41 41 41 41 41 41 41 41 41 41 41 41 41 41 41 41 41 41 41 41 41 41 41 41 41 41 41 41 41 41 41 41 41 41 41 
41 41 41 41 43 43 43 41 41 41 41 41 41 41 41 41 41 40 41 41 40 41 41 41 41 41 41 41 41 40 41 41 41 40 41 41 41 41 41 40 41 41 41 41 40 41 41 41 41 41 
41 41 41 45 49 49 49 48 41 40 43 43 43 43 43 41 41 41 41 41 41 41 41 41 41 41 41 41 41 41 41 41 41 41 41 41 41 41 41 41 41 41 41 41 41 41 41 41 41 41 
41 40 47 49 49 49 49 49 48 45 49 49 49 49 49 48 41 41 41 40 41 41 41 41 41 41 40 41 41 41 41 41 41 41 41 41 41 41 41 41 41 41 41 41 41 41 41 41 41 41 
41 41 47 49 38 38 38 38 49 49 49 38 38 38 38 49 48 41 41 41 41 41 40 41 41 41 41 41 41 41 41 41 41 41 41 41 41 41 41 41 41 41 41 41 41 41 41 41 40 41 
40 41 45 49 38 50 38 38 38 38 38 38 39 38 38 38 49 48 41 41 41 41 41 41 41 41 41 41 41 41 41 41 41 41 41 41 41 41 41 41 41 41 41 41 41 41 41 41 41 41 
41 47 49 49 38 38 38 38 38 38 38 38 38 38 38 38 38 49 51 40 41 41 41 41 40 41 40 41 41 41 41 41 41 40 41 41 41 41 41 40 41 41 40 41 41 41 41 41 41 41 
41 47 49 49 38 38 38 38 38 39 38 38 38 39 38 38 38 49 48 43 43 41 41 41 41 41 43 43 41 41 41 41 41 41 41 41 41 41 41 41 41 41 41 41 41 41 41 41 41 41 
41 47 49 49 38 38 39 38 38 38 38 38 39 38 38 38 38 32 32 32 32 51 40 41 41 45 32 32 48 43 43 43 41 41 41 40 41 41 41 41 41 41 41 41 41 41 41 41 40 41 
41 47 49 49 49 49 38 38 38 38 38 38 44 42 42 42 42 46 38 38 32 48 43 43 45 32 49 49 32 32 32 32 48 41 41 41 41 41 41 41 41 41 41 41 41 41 41 41 41 41 
41 41 42 46 49 49 38 39 38 38 38 38 51 40 41 40 41 47 38 38 32 32 32 32 32 32 38 38 38 38 38 32 32 51 41 41 41 41 41 41 41 40 41 41 41 41 41 41 41 41 
41 41 41 41 46 49 49 38 38 38 38 39 51 41 41 41 40 47 39 38 38 38 49 32 38 38 38 38 38 38 38 38 32 48 41 41 41 41 41 41 40 41 41 41 41 41 41 41 41 41 
41 41 40 41 41 47 49 49 38 39 38 38 51 41 40 41 41 47 38 38 38 38 49 32 38 38 38 39 38 38 38 38 32 32 51 41 41 41 41 41 41 41 41 41 41 41 41 41 41 41 
41 41 41 41 41 41 46 49 49 38 38 38 48 43 43 43 43 45 38 38 38 38 49 32 38 38 38 38 38 39 38 38 49 32 51 41 41 40 41 41 41 41 41 41 41 41 41 41 41 41 
41 41 41 41 41 40 41 46 49 49 38 38 38 38 38 38 38 38 38 38 38 38 32 38 38 38 38 38 38 38 38 38 49 32 51 41 41 41 41 41 41 41 41 41 41 41 41 41 41 41 
41 41 41 40 41 41 41 41 42 46 49 49 38 38 38 38 38 38 38 39 38 38 38 38 38 38 38 38 38 32 32 32 32 44 41 40 41 41 41 41 41 41 41 41 41 41 41 41 41 41 
41 41 41 41 41 41 41 41 40 41 42 46 32 32 32 38 39 39 38 38 38 32 32 49 49 49 49 49 49 32 44 42 42 41 41 40 41 41 41 41 41 41 41 41 41 41 41 41 41 41 
41 41 41 41 41 41 41 41 41 41 40 41 40 46 32 38 38 38 38 38 38 32 32 32 32 32 32 32 32 32 48 41 40 41 41 41 41 41 40 41 41 41 41 40 41 41 41 41 41 41 
41 41 41 41 41 41 41 41 41 41 41 41 41 47 32 39 38 38 38 38 38 32 49 49 49 49 49 49 49 49 49 48 41 41 41 41 41 41 41 41 41 41 41 41 41 41 41 41 41 41 
41 41 41 41 41 41 41 41 41 41 40 41 41 47 32 32 49 38 38 38 39 32 38 38 39 38 38 38 38 38 38 49 48 41 41 41 41 41 40 41 41 41 41 41 41 41 41 41 41 41 
41 40 41 41 41 41 41 41 41 41 41 41 41 41 46 32 49 38 38 38 38 32 32 32 32 32 32 38 39 38 38 38 49 48 40 41 41 41 41 41 41 41 41 41 41 41 41 41 41 41 
41 41 41 40 41 41 41 41 41 41 41 41 41 40 47 32 49 38 38 38 38 38 38 38 38 38 38 38 38 38 38 38 38 49 48 43 43 43 43 43 41 41 41 41 40 41 41 41 41 41 
41 41 41 41 41 41 41 41 41 40 41 41 41 41 45 32 49 38 38 38 38 32 32 32 32 32 38 38 38 39 38 38 38 38 49 49 49 49 49 49 48 43 43 41 41 41 41 41 41 41 
41 41 41 41 41 41 41 41 41 43 43 43 43 45 32 32 49 38 39 38 38 32 49 38 38 38 38 38 38 38 38 38 38 38 32 32 32 32 32 49 49 49 49 48 41 41 41 41 41 41 
41 41 41 41 41 41 41 43 45 32 32 32 32 32 32 49 49 38 38 38 38 32 38 38 39 38 38 39 38 38 38 39 38 38 38 38 38 38 32 32 32 38 38 49 51 41 40 41 41 41 
41 41 41 40 41 41 47 32 32 32 39 38 49 32 32 49 49 49 49 38 38 32 49 38 38 38 38 38 38 38 38 38 38 38 38 39 38 38 38 39 32 38 38 49 51 41 41 41 41 41 
41 41 41 41 41 41 47 32 49 49 38 38 38 49 32 32 32 32 32 39 38 32 32 32 32 32 32 32 32 32 32 32 32 32 32 32 32 32 32 32 32 32 32 49 49 41 41 41 41 41 
41 41 41 41 41 41 45 32 49 38 38 39 38 38 49 32 32 32 32 38 38 49 49 49 49 32 49 49 49 49 49 49 49 49 49 49 49 49 49 49 49 49 49 32 49 48 43 41 41 40 
41 41 40 41 41 47 49 32 49 49 38 38 38 39 38 49 49 49 49 38 38 38 38 38 39 32 38 38 38 38 38 38 38 39 38 38 38 38 38 38 38 49 49 32 49 49 49 48 41 41 
41 41 40 41 41 47 49 32 32 32 49 38 38 38 38 38 38 38 38 38 38 38 38 38 38 32 38 39 38 38 38 38 38 38 39 38 38 38 39 38 38 38 49 32 32 32 49 49 51 41 
41 41 41 40 41 47 49 49 49 32 49 49 49 49 49 38 38 38 38 38 39 38 38 39 38 32 38 38 38 38 39 38 38 38 38 38 38 38 38 38 38 39 49 49 49 32 32 49 51 41 
41 41 41 41 41 40 42 46 49 32 32 32 32 32 49 38 39 38 38 38 38 38 38 38 38 32 38 39 38 38 38 38 38 38 38 38 38 39 38 38 38 49 32 32 32 32 32 49 51 41 
41 41 41 41 41 41 41 41 46 49 49 49 49 32 49 38 38 38 38 39 38 38 38 38 38 38 38 38 38 38 38 38 39 38 38 38 38 38 38 38 49 49 32 49 49 49 49 44 41 41 
41 41 41 41 41 40 41 41 41 42 42 46 49 32 32 49 49 49 38 38 49 49 49 49 49 32 39 38 39 38 38 38 38 38 49 49 49 49 49 49 32 32 32 44 42 42 42 41 41 41 
41 41 41 41 41 41 41 41 41 41 41 41 46 49 32 32 32 49 38 49 32 32 32 32 49 32 49 49 49 49 49 49 49 49 49 32 32 32 32 32 32 44 42 41 41 41 41 41 41 41 
41 41 41 41 41 41 41 41 41 40 41 41 41 46 49 49 32 49 39 49 32 44 46 32 49 32 49 32 32 32 32 32 32 32 32 32 44 42 42 42 42 41 41 41 41 41 41 40 41 41 
41 41 41 41 41 41 41 41 41 41 41 41 41 41 46 49 32 49 49 32 44 41 47 32 32 49 49 32 44 42 42 42 42 42 42 42 40 40 41 41 41 41 41 41 40 41 41 41 41 41 
41 41 41 40 41 41 41 41 41 41 41 41 40 41 41 46 32 32 32 32 51 41 41 46 32 32 32 32 51 41 40 41 41 41 41 41 41 41 41 41 41 41 41 41 41 41 41 41 41 41 
41 41 41 40 41 41 41 41 41 41 41 41 41 41 41 41 42 42 42 42 41 41 41 41 42 42 42 42 41 41 41 41 41 41 41 41 41 41 41 40 41 41 41 40 41 41 41 41 41 41 
41 41 41 41 41 41 41 41 41 40 41 41 41 41 41 41 40 41 41 41 41 41 41 41 41 41 41 41 41 41 41 40 41 41 41 41 40 41 41 41 41 41 41 41 41 41 41 41 40 41 
41 41 41 41 41 41 41 41 41 41 41 41 41 41 41 41 41 41 41 41 41 40 41 41 41 41 40 41 41 41 41 41 41 41 41 41 41 41 41 40 41 41 40 41 41 41 41 41 41 41 
41 41 41 41 41 41 40 41 41 41 41 41 41 41 41 41 41 41 41 41 41 41 41 41 41 41 41 41 41 41 41 41 41 41 41 41 41 41 41 41 41 41 41 41 41 41 41 41 41 41 
41 41 41 41 41 41 40 41 41 41 41 41 40 41 41 41 41 41 40 41 41 41 41 41 41 41 40 41 40 41 41 41 40 41 41 41 41 41 41 41 41 41 41 41 41 41 41 41 41 41 
41 41 41 41 41 41 41 41 41 41 41 41 41 41 41 41 41 41 41 41 41 41 41 41 41 41 41 41 41 41 41 41 41 41 41 41 41 41 41 41 41 41 41 41 41 41 41 41 41 41 
41 41 41 41 41 41 41 41 41 41 41 41 41 41 41 41 40 41 41 41 41 41 41 41 40 41 41 41 41 41 40 41 41 41 41 41 41 41 41 41 41 41 41 41 41 41 41 41 41 41 
41 41 41 41 41 41 41 41 41 41 41 41 41 41 41 41 41 41 41 41 40 41 41 41 41 41 41 41 41 41 41 41 41 41 41 41 41 41 41 41 41 41 40 41 41 41 41 41 41 41 
41 41 41 41 41 41 41 41 41 41 41 41 41 41 41 41 41 41 41 41 41 41 41 41 41 41 41 41 41 41 41 41 41 41 41 41 41 41 41 41 41 41 41 41 41 41 41 41 40 41 
41 41 41 41 41 41 41 41 41 41 41 41 41 41 41 41 41 41 41 41 41 41 41 41 41 41 41 41 41 41 41 41 41 41 41 41 41 41 41 41 41 41 41 41 41 41 41 41 41 41 
41 41 41 41 41 41 41 41 41 41 41 41 41 41 41 41 41 41 41 41 41 41 41 41 41 41 41 41 41 41 41 41 41 41 41 41 41 41 41 40 41 41 41 41 41 41 41 41 40 41 
41 41 41 41 41 41 41 41 41 41 41 41 41 41 41 41 41 41 41 41 41 41 41 41 41 41 41 41 41 41 41 41 41 41 41 41 41 41 41 41 41 41 41 41 41 41 41 41 41 41 
